King Gizzard & The Lizard Wizard - Infest the Rats’ Nest

Flying Lotus - You’re Dead!

Open Mike Eagle - Brick Body Kids Still Daydream

Slauson Malone - A Quiet Farwell, 2016-2018

Yazz Ahmed - Polyhymnia

Tim Hecker - Ravedeath, 1972

Mark Kozelek & Jimmy LaValle - Perils from the Sea

U.S. Girls - In a Poem Unlimited

Idles - Joy as an Act of Resistance

Denzel Curry - Taboo

Leviathan - Scar Sighted

SOPHIE - Oil of Every Pearl’s Un-Insides

Angel Olsen - My Woman

Alan Vega - It

Tyler The Creator - Flower Boy

Uncommon Nasa - New York Telephone

slowthai - Nothing Great About Britain

Touché Amoré - Stage 4

Kali Uchis - Isolation

Dean Blunt - Black Metal

Oxbow - Thin Black Duke

Africa Hitech - 93 Million Miles

The Oh Sees - Orc

Horrendous - Idol

Mariam the Believer - Blood Donation

Earl Sweatshirt - Some Rap Songs

Beyoncé - Lemonade

Crystal Stilts - In Love with Oblivion

Injury Reserve - Floss

Jeff Rosenstock - Worry

Iglooghost - Neo Wax Bloom

Sleep - The Sciences

This Routine Is Hell - Howl

James Blake - Self-Titled

Neil Cicierega - Mouth Moods

Lizzo - Cuz I Love You

Purple Mountains - Self-Titled

C418 - Minecraft OST

Colin Stetson - New History Warfare Vol. 2

Leonard Cohen - You Want It Darker

Timber Timbre - Hot Dreams

Armand Hammer - Paraffin

Deerhunter - Halcyon Digest

Kvelertak - Self-Titled

High On Fire - Luminiferous

Ratking - So It Goes

Panopticon - Roads to the North

Waka Flocka Flame - Flockaveli

St. Vincent - Strange Mercy

Noname - Room 25

Deafheaven - Sunbather

SZA - Ctrl

Chuck Person - Eccojams Vol. 1

Arcade Fire - The Suburbs

Vampire Weekend - Contra

Chelsea Wolfe - Abyss

Spiritualized - Sweet Heart Sweet Light

Indian - From All Purity

Pusha T - Daytona

BADBADNOTGOOD - BBNG2

Lana Del Rey - Norman Fucking Rockwell!

Sturgill Simpson - A Sailor’s Guide to Earth

Solange - A Seat at the Table

Ab-Soul - Control System

Converge - All We Love We Leave Behind

A$AP Rocky - Live Love A$AP

James Ferraro - Far Side Virtual

Lil B - God’s Father

Traxman - Da Mind of Traxman

Gil Scott Heron - I’m New Here

Godspeed You! Black Emperor - ‘Allelujah! Don't Bend! Ascend!

Kyary Pamyu Pamyu - Nandacollection

Playboi Carti - Die Lit

Portico Quartet - Self-Titled

Anderson .Paak - Oxnard

Little Women - Throat

Deerhoof - Breakup Song

Jay-Z - 4:44

Everything Everything - Get to Heaven

Ka - The Knights Gambit

Carly Rae Jepsen - E.MO.TION

Autechre - Exai

Jon Hopkins - Immunity

MGMT - Congratulations

Bill Callahan - Dream River

Gorguts - Colored Sands

Drake - If You’re Reading This It’s Too Late

Kurt Vile - Wakin on a Pretty Daze

Tame Impala - Lonerism

The Weeknd - Trilogy

Lil Ugly Mane - Mista Thug Isolation

Sufjan Stevens - Carrie & Lowell

Neon Indian - VEGA INTL. Night School

Tierra Whack - Whack World

Mac Miller - Faces

The Caretaker - An Empty Bliss Beyond This World

George Clanton - Slide

Viagra Boys - Street Worms

Titus Andronicus - The Monitor

Farrah Abraham - My Teenage Dream Ended